Year,Retirement Annuities,Survivors Annuities,Revisionary Annuities,Total Recurring Benefit Payments,Termination Refunds
2005,263,132,2,397,1
2006,267,126,2,395,2
2007,272,125,2,399,4
2008,269,125,1,395,1
2009,275,125,1,401,2
2010,278,119,1,398,2
2011,291,118,1,410,1
2012,294,119,1,414,2
2013,310,118,1,429,â€“
2014,303,117,1,421,8
